#######################
#**#                  #
#* #******************#
#* #######     *      #
#* #*****#    ***     #
#* #####*#     *      #
#*********************#
#######################